3 9 10 9 10 9 12 14 9 10 
3 3 5 6 5 6 9 12 6 3 
3 1 12 12 12 10 5 10 9 2 
3 5 12 8 14 5 10 3 3 7 
3 13 8 6 9 10 5 6 5 10 
5 10 5 14 3 3 9 12 10 3 
9 6 9 12 6 5 6 11 3 3 
3 13 4 10 13 10 9 4 6 3 
5 12 10 5 10 1 6 9 12 2 
13 12 4 12 6 5 12 6 13 2 
